#Example: Large parts of Africa and south east Asia
tropical = { 
}
arid = { 
}
arctic = { 
	1 2 3 44
}
#Example: Most of Europe north of med.
mild_winter = { 
}
#Example: Inland Europe & Scandinavia
normal_winter = { 	
	45 46 47 48 49 50 51 52 53 54 55 56 57 58 59 60 63 64 65 66 67 68 69 70 71 72 73 74 75
	76 77 78 79 80 81 82 83 84 86 87 88 89 90 91 115 133 134 135 136 137 138 139
	141 142 145 146 147 148 149 150 151 152 153 154 155 156 157 158 
	159 160 161 165 166 167 169 170 171 172 173 174 175 176 177 178
	179 210 213 214 215 216 217 218 220 222 223 224 225 226 227 229 230 231 232 233 234 235
	236 237 238 239 240 241 245 246 247 248 249 250 253 257  
	330 331 332 333 334 335 336 337 338 339 340 341 342 343 344 
	345 346 347 348 349 350 351 352 353 354 355 356 357 358 359 360 
	361 362 363 364 365 366 367 368 369 370 371 372 373 374 375 376 
	377 378 379 380 381 382 383 384 385 386 387 388 389 390 391 392 
	393 394 395 396 397 398 399 400 401 402 403 404 405 406 407 408 
	409 410 411 412 413 414 415 416 417 418 419 420 421 422 423 424 
	425 426 427 428 429 430 431 432 433 434 435 436 437 438 439 440 
	441 442 443 444 445 446 447 448 449 450 451 452 453 454 455 456 461 463 464
}
#Example: Russia & Lappland
severe_winter = { 
	#Western Islands
	1 2 3 44 61 62 140 143 144 162 163 164 168 211 212 221 228 242 243 244 251 252 254 255 256 258 259 260 261 262 263 264 265 266 267 268 269
	270 271 272 273 274 275 276 277 278 279 280 281 282 283 284 285 286 457 458 459 460 462
	
}
impassable = { 
	36 61 62 42 40 41 116 117 118 119 120 121 122 123 124 125 126 127 128 129 130 131 132
	143 144 162 163 164 143 144 162 163 164 211 212 243 244 263 269 276 283 284 286 399
	23 32 43 37
}
mild_monsoon = { 
}
normal_monsoon = { 
}
severe_monsoon = { 
}
equator_y_on_province_image = 1
